Synth_Class	KEYWORD1
SquareSynth_Class	KEYWORD1
SquareSynth	KEYWORD1
Synth	KEYWORD1
Channel	KEYWORD1
tempo	KEYWORD2
proceed	KEYWORD2
sixteenth	KEYWORD2
eighth	KEYWORD2
quarter	KEYWORD2
half	KEYWORD2
whole	KEYWORD2
begin	KEYWORD2
generate	KEYWORD2
noteOn	KEYWORD2
noteOff	KEYWORD2
clearFlags	KEYWORD2
pitchBend	KEYWORD2
arpeggioOn	KEYWORD2
arpeggioOff	KEYWORD2
addDepth	KEYWORD2
dutyCycle	KEYWORD2
noise	KEYWORD2
transform	KEYWORD2
note	KEYWORD2
bool	KEYWORD2
